###################
# Player 1        #
# Round:  20      #
# Kills:   1      #
# Lives: 0        #
# Missiles: 0/2   #
###################
#        XXXMMM   #
#          VVV    #
# ---       ----- #
# ---       ----- #
# ---       - --- #
#                 #
#      |          #
#                 #
#                 #
#    x  x         #
#                 #
#                 #
#                 #
# x  x  x         #
#                 #
#                 #
#         |       #
#                 #
# ---   --    --  #
# ---   ---   --- #
# ---     -   --- #
#        AAA      #
#       XXX       #
###################
# Missiles: 0/1   #
# Lives: 0        #
# Kills:   0      #
# Round:  20      #
# Player 2        #
###################

